0000000000000000000000
0000000000000000000000
0000000000000000000000
0000022222000030303000
0000020002000000000000
0000020002000030003000
0000020002000000000000
0000022022000030303000
0000000000000000000000
0000000000000000000000
0000000000000000000000
000000x000888888888888
0000000000000000000000
0000000000000000000000
0000000000000000000007
4444444400000000000007
4040000400000000000007
4000050400000000000007
4040000400000000000007
4044444400000000000007
4000000000000000000000
4444444400000066666600
